%instrukcja: 1 upewnij sie ze kazda linia ma tyle samo znakow (spacja to znak) 2 * to glowa gracza, pozcja niezmieniać pozycji%
111111111111111111111111111111111111111111111111111111111111111111111111111111111111111111111111111111
1                                                                                                    1
1                                                                                                    1
1          *                                                                                         1
1                                                                                                    1
1     2222222222222222222222222222222222222222222222222                                              1
1                                                       2  22                                        1
1                                                             2   2222                               1
1                                                                     2                              1
1                                                                       22                           1
1                                                                          2                         1
1                                                                              2222222222222         1
1                                                                                           2        1
1                                                                                                    1
1                                                                                                  221
1                                                                                                    1
1                                                                                              2     1
1                                                                                                    1
1                                                                                  2222222222222222221
1                                                                                 2                  1
1                                                                           22222                    1
1                                                                       2                            1
1                                                            2222222                                 1
1                                                       2                                            1
1                                              222222                                                1
1                                         2                                                          1
1                                 2222                                                               1
1                                                                                                    1
1                            2                                                                       1
1                  2222222                                                                           1
1                                                                                                    1
1         e     2                                                                                    1
1     2222222                                                                                        1
1                                                                                                    1
122                                                                                                  1
1                                                                                                    1
1                                                                                                    1
1      222                                                                                           1
1                                                                                                    1
111111111111111111111111111111111111111111111111111111111111111111111111111111111111111111111111111111