%instrukcja: 1 upewnij sie ze kazda linia ma tyle samo znakow (spacja to znak) 2 * to glowa gracza, pozcja niezmieniać pozycji%
222222222222222222222222222222222222222222222222222222222222222222222222222222222222222222222222222222
2                                                                                                    2
2                                                                                                    2
2     e                                                                                              2
2     3                e    3                                                                        2
2     3333333333333333333333333333333333333333333333333                                              2
2                                                       33333                                        2
2                                                             3   3333                               2
2                                                                     3                              2
2                                                                       33                           2
2                                                                          3                         2
2                                                                              3333333333333         2
2                                                                                           3        2
2                                                                                                    2
2                                                                                                  332
2                                                                                                    2
2                                                                                              3     2
2                                                                                                    2
2                                                                                   333333333333333332
2                                                                                 3                  2
2                                                                           33333                    2
2                                                                       3                            2
2                                                            3333333                                 2
2                                                       3                                            2
2                                              333333                                                2
2                                         3                                                          2
2                                 3333                                                               2
2                                                                                                    2
2                  3   e 3   3                                                                       2
2                  3333333                                                                           2
2                                                                                                    2
2      e        3                                                                                    2
2     3333333                                                                                        2
2                                                                                                    2
233                                                                                                  2
2                                                                                                    2
2     33333                                                                                          2
2 *                                                                                                  2
2                                e                                                                   2
211111111111111111111111111111111111111111111111111111111111111111111111111111111111111111111111111112